1111111111
10000000C1
1000000011
1000000001
1111111111