1111111111
1P000000C1
1000000011
1000000001
1111111111