1111111111
1P000000C1
1000E00011
10000000E1
1111111111