1111111111
1P000000C1
1000P00011
1000000001
1111111111