1111111111
1P000000C1
11111C1111
1C00000EC1
1111111111
