1111111111
1P000000C1
111C111111
1000000EC1
1111111111
