1111111111
1P000000C1
100011C111
1000000E01
1111111111