1111111111
1P000010C1
1000011111
10000000E1
1111111111