1111111111
1P000000C1
111C111111
1C00000E01
1111111111
