11111
10CE1
11101
10001
1P001
11111